NO ./assets/Alic3D/WN_lvl1.xpm
SO ./assets/Alic3D/WS_lvl1.xpm
WE ./assets/Alic3D/WE_lvl1.xpm
EA ./assets/Alic3D/WW_lvl1.xpm

F                       255, 215, 0
C 50,255,             255

111111111111111111111
100000000000000000001
101111111111111111101
101000000000000000101
1010111111111111101L1
10101D000000000010101
1010100000000000001B1
101011111111111111101
100000000T000000000W1
111111111111111111111