NO ./assets/Alic3D/WN_lvl1.xpm
SO ./assets/Alic3D/WS_lvl1.xpm
WE ./assets/Alic3D/WE_lvl1.xpm
EA ./assets/Alic3D/WW_lvl1.xpm

F                       255, 215, 0
C 50,255,             255

111111111111111111111
100000000000000000001
101111111111111111101
101000000000000000101
101011111111111110101
101010000000000010101
101010111111101010101
101010100000001010101
101010101111101010101
101010101000101010101
101010101101101010101
101010101000101010101
101010101110101010101
101010100000001010101
101010111111111010101
101010000000000000101
101011111111111111101
1D0000000T000000000W1
111111111111111111111