NO ./assets/Alic3D/wall_n_2.xpm
SO ./assets/Alic3D/wall_2.xpm
WE ./assets/Alic3D/wall_0.xpm
EA ./assets/Alic3D/wall_1.xpm

F 255,215,0
C 0,255,255

111111111111111111111
100000000000000000001
101111111111111111101
101000000000000000101
101011111111111110101
101010000000000010101
101010111111111010101
101010100000001010101
101010101111101010101
101010101000101010101
101010101011101010101
101010101000101010101
101010101111101010101
101010100000001010101
101010111111111010101
101010000000000010101
101011111111111110101
1000000000000000000N1
111111111111111111111