..........
.        .
.  .     .
.    .  ..
.   N    .
...    ...
. ...    .
.        .
..........