..........
.        .
.  .     .
.    .  ..
.        .
...    ...
. ..N    .
.        .
..........