NO ./assets/Alic3D/WN_lvl1.xpm
SO ./assets/Alic3D/WS_lvl1.xpm
WE ./assets/Alic3D/WE_lvl1.xpm
EA ./assets/Alic3D/WW_lvl1.xpm

F                       255, 215, 0
C 50,255,             255

111111111111111111111
1000000B00T000L000001
1D000L00000B0000T00W1
111111111111111111111