NO         ./assets/Alic3D/WN_lvl1.xpm
NO         ./assets/Alic3D/WN_lvl1.xpm
NO         ./assets/Alic3D/WN_lvl1.xpm


SO ./assets/Alic3D/WS_lvl1.xpm
WE ./assets/Alic3D/WE_lvl1.xpm

EA ./assets/Alic3D/WW_lvl1.xpm


F              254  , 255  ,0
C 50,255,             255

              111
              1T1
111111111111111011111
10000000000000000000111
1011L11B110111B111100L1
10100000000000000010111
101011111111011110101
101000000000000010B01
100010111111101010101
10101B100010001010101
101010101111011010L01
101010100000010010101
10B0101000L0101010101
1010101B1000101010101
101010001000101010101
101000100000000010001
101010111101111010101
10001000000000B000101
101011111000111111101
100000000000000000001
111100011101110001111
    110001D100011 
      100101001
       1000001
        10001
         101
         101
         1N1
         111