NO ./assets/Mandatory/red.xpm

WE ./assets/Mandatory/yellow.xpm


SO ./assets/Mandatory/blue.xpm
EA ./assets/Mandatory/red.xpm

F          25, 6, 7

C 40 ,5,6

1111111111111111111111111111111
10000000001100000000000001    11111
10110000011100000000000001    10001
100111111W0000000000000001    11111
11111111111100111111111111111111111
1000000000110011111
111101111111000111
11110111111100111111111111111
11000000110101010100000010001
10000000000000000000000000001
10000000000000000001000000011
1100000111010101111101111000111
11110111 1110101 101111010001
11111111 1111111 111111111111
